%%%%%%%%%%%%%%%%%%%%
%..o..%...o......%.%
%.%%%.%.%%%%%%%.%%.%
%...%.%.%.%.....%o.%
%%%o%.%.%.%..%%%%..%
%...%...%.........%%
%.%%.%%%%G.%%P%%%..%
%.....%.%..G..%.oo.%
%.%.%.%.%%.%%%%G%%.%
%...%.G......o.....%
%%%%%%%%%%%%%%%%%%%%