%%%%%%%
% P   %
% %%% %
% %.  %
% %%% %
%. 4  %
%%%%%%%
