%%%%%%%%%%%%%%%
%....o%.......%
%.%%.%%.%.%%%.%
%...%.........%
%o%.%..%%%%.%.%
%.%...%...%...%
%..%%%%%%...%%%
%....GG.%.....%
%%%..%%o...%..%
%.%.....%.o.%.%
%.%..o%.%.%.%.%
%o..%...%...%.%
%G%%%%%..o%...%
%...G.P.......%
%%%%%%%%%%%%%%%