%%%%%%%%%%%%%%%
%.....%.......%
%.%%%%%.%%%%%.%
%...%.......%.%
%.%.%.%%%%%%%.%
%.%...%...%...%
%..%%%%%%.%.%%%
%....GG.%.%...%
%%%..%%.%.%%..%
%.%...%.%...%.%
%.%.%.%.%.%.%.%
%...%...%...%.%
%o%%%%%.%o%%..%
%...G.P.......%
%%%%%%%%%%%%%%%